Trial	CorrectionTrial?	StartTime	CenterReward?	F1	F2	F3	F4	HoldTime	Atten	Pitch	Side	Response	RespTime	Correct	
1	0	8.6341	0	730	2058	2857	4205	701	-17.0	200	1	0	14.2322	0	
2	1	24.2499	0	730	2058	2857	4205	701	-17.0	200	1	1	26.0340	1	
3	0	30.8097	0	460	1105	2857	4205	501	-15.0	200	0	0	31.8737	1	
4	0	37.7582	1	460	1105	2857	4205	651	-9.0	200	0	0	41.3808	1	
5	0	49.9702	0	460	1105	2857	4205	951	-15.0	200	0	0	50.9101	1	
6	0	60.5226	0	460	1105	2857	4205	501	-20.0	200	-1	0	61.1104	-1	
7	0	67.8740	0	730	2058	2857	4205	851	-17.0	200	1	1	68.6022	1	
8	0	73.6636	0	730	2058	2857	4205	601	-11.0	200	1	1	74.7060	1	
9	0	80.1482	0	460	1105	2857	4205	801	-15.0	200	0	0	80.9677	1	
10	0	87.5601	0	460	1105	2857	4205	501	-20.0	200	-1	0	88.6177	-1	
11	0	95.6128	0	730	2058	2857	4205	751	-11.0	200	1	1	96.3887	1	
12	0	102.6446	0	460	1105	2857	4205	1001	-9.0	200	0	0	103.0150	1	
13	0	108.4746	0	730	2058	2857	4205	501	-18.5	200	-1	0	109.4278	-1	
14	0	115.1900	0	730	2058	2857	4205	501	-11.0	200	1	1	117.5662	1	
15	0	122.8305	0	730	2058	2857	4205	651	-11.0	200	1	1	123.5319	1	
16	0	129.8222	0	460	1105	2857	4205	851	-15.0	200	0	0	130.1457	1	
17	0	138.7891	0	730	2058	2857	4205	501	-18.5	200	-1	1	139.8032	-1	
18	0	146.2039	0	730	2058	2857	4205	901	-11.0	200	1	1	146.6525	1	
19	0	152.8479	0	730	2058	2857	4205	801	-11.0	200	1	1	153.4956	1	
20	0	159.7357	1	460	1105	2857	4205	701	-9.0	200	0	0	160.2495	1	
21	0	167.5317	1	460	1105	2857	4205	601	-9.0	200	0	1	178.6184	0	
22	1	186.9867	0	460	1105	2857	4205	601	-9.0	200	0	0	187.8202	1	
23	0	195.1707	0	460	1105	2857	4205	1001	-9.0	200	0	0	195.6252	1	
24	0	205.1426	0	730	2058	2857	4205	801	-11.0	200	1	1	205.5371	1	
25	0	210.7522	0	460	1105	2857	4205	501	-20.0	200	-1	1	211.8062	-1	
26	0	218.3584	0	460	1105	2857	4205	951	-9.0	200	0	0	219.1488	1	
27	0	227.3951	0	730	2058	2857	4205	851	-11.0	200	1	1	228.0524	1	
28	0	234.2831	0	730	2058	2857	4205	751	-11.0	200	1	1	234.8420	1	
29	0	241.2133	0	730	2058	2857	4205	501	-18.5	200	-1	1	242.0850	-1	
30	0	249.0918	0	460	1105	2857	4205	651	-15.0	200	0	0	249.6069	1	
31	0	258.7541	0	730	2058	2857	4205	501	-11.0	200	1	1	259.9723	1	
32	0	265.1219	0	460	1105	2857	4205	551	-9.0	200	0	0	265.8847	1	
33	0	274.7742	0	460	1105	2857	4205	501	-20.0	200	-1	1	275.7550	-1	
34	0	280.9184	0	460	1105	2857	4205	501	-15.0	200	0	0	281.6359	1	
35	0	289.2351	0	460	1105	2857	4205	751	-9.0	200	0	0	289.8806	1	
36	0	302.9354	0	730	2058	2857	4205	1001	-11.0	200	1	1	303.6487	1	
37	0	310.4653	0	730	2058	2857	4205	901	-17.0	200	1	1	311.1332	1	
38	0	316.8548	0	730	2058	2857	4205	501	-18.5	200	-1	1	317.9545	-1	
39	0	329.1915	0	460	1105	2857	4205	851	-9.0	200	0	0	329.5972	1	
40	0	336.5494	0	730	2058	2857	4205	801	-11.0	200	1	1	336.9533	1	
41	0	342.4338	0	460	1105	2857	4205	501	-20.0	200	-1	1	343.2879	-1	
42	0	348.2365	0	460	1105	2857	4205	551	-15.0	200	0	0	348.9354	1	
43	0	356.4385	0	730	2058	2857	4205	701	-17.0	200	1	1	356.9126	1	
44	0	362.5838	0	460	1105	2857	4205	1001	-15.0	200	0	0	363.1819	1	
45	0	369.3189	0	730	2058	2857	4205	501	-18.5	200	-1	0	370.1912	-1	
46	0	377.4515	0	730	2058	2857	4205	901	-11.0	200	1	1	378.0585	1	
47	0	384.7940	0	730	2058	2857	4205	951	-17.0	200	1	1	385.1869	1	
48	0	390.7779	0	460	1105	2857	4205	651	-15.0	200	0	0	391.5771	1	
49	0	397.6789	0	460	1105	2857	4205	501	-20.0	200	-1	0	398.6746	-1	
50	0	405.9088	0	730	2058	2857	4205	751	-17.0	200	1	1	406.5305	1	
51	0	415.3976	0	460	1105	2857	4205	501	-20.0	200	-1	0	416.3455	-1	
52	0	424.6802	0	730	2058	2857	4205	501	-18.5	200	-1	1	425.3296	-1	
53	0	434.2573	0	730	2058	2857	4205	551	-11.0	200	1	1	435.2993	1	
54	0	444.5959	0	460	1105	2857	4205	801	-9.0	200	0	0	445.4663	1	
55	0	454.3033	0	460	1105	2857	4205	1001	-15.0	200	0	1	455.0558	0	
56	1	463.1272	0	460	1105	2857	4205	1001	-15.0	200	0	1	463.5543	0	
57	1	470.7352	0	460	1105	2857	4205	1001	-15.0	200	0	0	471.4519	1	
58	0	478.9215	1	460	1105	2857	4205	901	-9.0	200	0	0	480.5668	1	
59	0	487.7887	0	730	2058	2857	4205	951	-11.0	200	1	0	490.0320	0	
60	1	497.9998	0	730	2058	2857	4205	951	-11.0	200	1	1	498.5729	1	
61	0	504.7315	0	460	1105	2857	4205	851	-15.0	200	0	0	505.5080	1	
62	0	512.0517	0	730	2058	2857	4205	601	-11.0	200	1	1	512.9822	1	
63	0	518.5426	0	460	1105	2857	4205	651	-15.0	200	0	0	519.0216	1	
64	0	526.0338	0	460	1105	2857	4205	501	-20.0	200	-1	1	526.9609	-1	
65	0	533.2969	0	730	2058	2857	4205	501	-18.5	200	-1	1	533.9814	-1	
66	0	539.0367	0	730	2058	2857	4205	701	-17.0	200	1	1	539.8647	1	
67	0	546.1373	0	460	1105	2857	4205	751	-9.0	200	0	0	546.4789	1	
68	0	552.5360	0	730	2058	2857	4205	851	-11.0	200	1	1	553.2792	1	
69	0	558.7036	0	730	2058	2857	4205	951	-11.0	200	1	1	559.1708	1	
70	0	565.7864	0	460	1105	2857	4205	501	-15.0	200	0	0	566.3520	1	
71	0	573.1774	0	730	2058	2857	4205	501	-18.5	200	-1	0	574.0920	-1	
72	0	579.6125	0	460	1105	2857	4205	501	-20.0	200	-1	0	580.7335	-1	
73	0	588.4365	0	730	2058	2857	4205	1001	-11.0	200	1	1	588.9259	1	
74	0	594.9664	1	730	2058	2857	4205	801	-11.0	200	1	1	596.7115	1	
75	0	605.1576	0	460	1105	2857	4205	851	-9.0	200	0	0	605.7731	1	
76	0	612.5656	0	460	1105	2857	4205	1001	-9.0	200	0	0	613.3893	1	
77	0	619.7033	0	730	2058	2857	4205	501	-18.5	200	-1	1	620.5146	-1	
78	0	625.8584	0	460	1105	2857	4205	951	-15.0	200	0	0	626.8394	1	
79	0	632.7871	0	730	2058	2857	4205	901	-17.0	200	1	1	633.8454	1	
80	0	639.8469	0	460	1105	2857	4205	501	-20.0	200	-1	1	641.0190	-1	
81	0	646.8110	0	730	2058	2857	4205	801	-11.0	200	1	1	647.5356	1	
82	0	655.2471	0	730	2058	2857	4205	551	-11.0	200	1	1	655.8239	1	
83	0	670.0231	0	460	1105	2857	4205	751	-15.0	200	0	0	670.8849	1	
84	0	677.8397	0	460	1105	2857	4205	601	-15.0	200	0	0	678.8454	1	
85	0	686.8903	0	460	1105	2857	4205	501	-20.0	200	-1	1	687.9908	-1	
86	0	693.6131	0	460	1105	2857	4205	1001	-9.0	200	0	0	694.7334	1	
87	0	701.4660	0	460	1105	2857	4205	801	-9.0	200	0	0	702.2959	1	
88	0	708.2720	0	730	2058	2857	4205	601	-11.0	200	1	1	709.1027	1	
89	0	714.7105	0	730	2058	2857	4205	501	-17.0	200	1	1	715.5412	1	
90	0	721.7170	0	730	2058	2857	4205	651	-11.0	200	1	1	722.5623	1	
91	0	728.9575	0	730	2058	2857	4205	501	-18.5	200	-1	0	729.6591	-1	
92	0	736.5288	0	460	1105	2857	4205	751	-15.0	200	0	1	737.5984	0	
93	1	751.7305	0	460	1105	2857	4205	751	-15.0	200	0	0	752.6556	1	
94	0	759.9165	0	730	2058	2857	4205	501	-18.5	200	-1	1	760.8011	-1	
95	0	770.0423	0	460	1105	2857	4205	701	-15.0	200	0	0	771.0334	1	
96	0	777.4622	0	460	1105	2857	4205	651	-15.0	200	0	1	778.3774	0	
97	1	786.3436	1	460	1105	2857	4205	651	-15.0	200	0	0	790.1499	1	
98	0	798.8414	0	460	1105	2857	4205	901	-15.0	200	0	0	799.2930	1	
99	0	807.8296	0	730	2058	2857	4205	1001	-17.0	200	1	1	808.7433	1	
100	0	813.2877	0	460	1105	2857	4205	501	-20.0	200	-1	0	814.6318	-1	
101	0	821.0063	0	730	2058	2857	4205	801	-11.0	200	1	1	821.6792	1	
102	0	827.6093	0	730	2058	2857	4205	601	-11.0	200	1	1	828.4869	1	
103	0	835.5974	0	460	1105	2857	4205	951	-9.0	200	0	1	836.2473	0	
104	1	842.6564	0	460	1105	2857	4205	951	-9.0	200	0	0	843.1176	1	
105	0	849.8613	0	460	1105	2857	4205	501	-20.0	200	-1	0	850.8250	-1	
106	0	857.1015	0	460	1105	2857	4205	551	-9.0	200	0	0	857.8690	1	
107	0	867.5647	0	730	2058	2857	4205	751	-11.0	200	1	1	868.4499	1	
108	0	873.5443	0	730	2058	2857	4205	651	-11.0	200	1	1	873.9246	1	
109	0	881.3280	0	730	2058	2857	4205	701	-11.0	200	1	1	881.9548	1	
110	0	888.0324	0	460	1105	2857	4205	801	-9.0	200	0	0	888.4140	1	
111	0	893.9444	0	730	2058	2857	4205	501	-18.5	200	-1	1	894.8495	-1	
112	0	902.5945	0	730	2058	2857	4205	901	-11.0	200	1	1	903.0944	1	
113	0	909.3190	0	460	1105	2857	4205	501	-9.0	200	0	0	910.1712	1	
114	0	922.3433	0	460	1105	2857	4205	501	-20.0	200	-1	1	923.1190	-1	
115	0	929.5698	0	730	2058	2857	4205	751	-11.0	200	1	1	930.1931	1	
116	0	943.5758	0	460	1105	2857	4205	1001	-9.0	200	0	0	944.2057	1	
117	0	951.7663	0	730	2058	2857	4205	501	-18.5	200	-1	1	952.3790	-1	
118	0	965.9621	0	730	2058	2857	4205	951	-17.0	200	1	1	966.8739	1	
119	0	972.6633	0	460	1105	2857	4205	801	-9.0	200	0	1	973.6988	0	
120	1	981.7359	1	460	1105	2857	4205	801	-9.0	200	0	0	982.9809	1	
121	0	988.4818	0	460	1105	2857	4205	751	-15.0	200	0	0	992.4580	1	
122	0	999.4510	0	460	1105	2857	4205	501	-9.0	200	0	0	1000.2557	1	
123	0	1008.9435	0	730	2058	2857	4205	1001	-11.0	200	1	1	1009.6026	1	
124	0	1015.1855	0	730	2058	2857	4205	901	-11.0	200	1	1	1015.7990	1	
125	0	1021.7021	0	730	2058	2857	4205	651	-17.0	200	1	1	1022.6491	1	
126	0	1029.4632	0	460	1105	2857	4205	551	-9.0	200	0	0	1030.3206	1	
127	0	1035.8889	0	730	2058	2857	4205	501	-18.5	200	-1	0	1037.4141	-1	
128	0	1044.1831	0	460	1105	2857	4205	501	-20.0	200	-1	1	1045.1637	-1	
129	0	1051.4062	0	730	2058	2857	4205	651	-17.0	200	1	1	1051.8680	1	
130	0	1057.6281	0	730	2058	2857	4205	501	-18.5	200	-1	0	1058.6625	-1	
131	0	1066.4502	0	730	2058	2857	4205	901	-17.0	200	1	1	1067.1097	1	
132	0	1073.4543	0	460	1105	2857	4205	751	-15.0	200	0	0	1074.1912	1	
133	0	1081.5083	0	460	1105	2857	4205	501	-20.0	200	-1	0	1082.5819	-1	
134	0	1089.4908	1	460	1105	2857	4205	851	-15.0	200	0	0	1090.7765	1	
135	0	1095.1574	1	460	1105	2857	4205	551	-15.0	200	0	1	1099.7563	0	
136	1	1108.0381	0	460	1105	2857	4205	551	-15.0	200	0	0	1109.4590	1	
137	0	1116.9330	0	730	2058	2857	4205	801	-17.0	200	1	1	1118.0863	1	
138	0	1125.6006	0	730	2058	2857	4205	601	-17.0	200	1	1	1126.5988	1	
139	0	1132.8242	0	730	2058	2857	4205	951	-17.0	200	1	1	1133.9095	1	
140	0	1141.0861	0	460	1105	2857	4205	501	-20.0	200	-1	0	1141.6522	-1	
141	0	1149.9217	0	460	1105	2857	4205	701	-9.0	200	0	0	1150.8258	1	
142	0	1159.0871	0	730	2058	2857	4205	1001	-11.0	200	1	1	1160.2964	1	
143	0	1165.7400	1	460	1105	2857	4205	801	-15.0	200	0	0	1166.6572	1	
144	0	1172.5133	0	730	2058	2857	4205	501	-18.5	200	-1	0	1179.8588	-1	
145	0	1189.5756	1	460	1105	2857	4205	901	-9.0	200	0	0	1191.5698	1	
146	0	1200.8763	0	730	2058	2857	4205	951	-17.0	200	1	1	1202.1246	1	
147	0	1210.5241	0	460	1105	2857	4205	651	-9.0	200	0	0	1211.2909	1	
148	0	1218.6902	0	460	1105	2857	4205	551	-9.0	200	0	0	1219.9830	1	
149	0	1227.3341	0	460	1105	2857	4205	501	-20.0	200	-1	1	1228.2665	-1	
150	0	1232.9839	0	730	2058	2857	4205	801	-17.0	200	1	1	1233.9053	1	
151	0	1241.2672	0	460	1105	2857	4205	901	-9.0	200	0	0	1241.8819	1	
152	0	1249.2322	0	730	2058	2857	4205	751	-11.0	200	1	1	1250.3160	1	
153	0	1254.9881	0	730	2058	2857	4205	501	-18.5	200	-1	1	1255.9067	-1	
154	0	1261.7980	0	460	1105	2857	4205	601	-15.0	200	0	0	1262.7627	1	
155	0	1270.2437	0	730	2058	2857	4205	501	-11.0	200	1	1	1271.0923	1	
156	0	1276.9172	0	730	2058	2857	4205	551	-17.0	200	1	1	1277.6193	1	
157	0	1285.1410	0	460	1105	2857	4205	1001	-9.0	200	0	0	1285.9843	1	
158	0	1293.9679	0	730	2058	2857	4205	951	-17.0	200	1	1	1294.7100	1	
159	0	1301.6173	0	730	2058	2857	4205	501	-18.5	200	-1	1	1302.6848	-1	
160	0	1309.5830	0	460	1105	2857	4205	501	-20.0	200	-1	1	1310.8682	-1	
161	0	1320.8292	0	460	1105	2857	4205	1001	-9.0	200	0	0	1321.2709	1	
162	0	1337.3928	0	730	2058	2857	4205	851	-11.0	200	1	1	1338.7157	1	
163	0	1348.3271	0	460	1105	2857	4205	601	-15.0	200	0	0	1349.6646	1	
164	0	1357.3108	0	730	2058	2857	4205	951	-11.0	200	1	1	1358.4342	1	
165	0	1363.4153	0	460	1105	2857	4205	501	-9.0	200	0	0	1364.2731	1	
166	0	1369.9704	0	730	2058	2857	4205	501	-18.5	200	-1	1	1371.4136	-1	
167	0	1376.0481	0	730	2058	2857	4205	701	-17.0	200	1	1	1376.8917	1	
168	0	1384.4126	0	460	1105	2857	4205	501	-20.0	200	-1	1	1385.7217	-1	
169	0	1390.9633	0	460	1105	2857	4205	651	-15.0	200	0	0	1391.9334	1	
170	0	1398.6895	0	460	1105	2857	4205	801	-15.0	200	0	0	1399.3710	1	
171	0	1406.4745	0	730	2058	2857	4205	851	-11.0	200	1	1	1407.4169	1	
172	0	1412.2148	0	460	1105	2857	4205	751	-9.0	200	0	1	1413.4836	0	
173	1	1421.8707	0	460	1105	2857	4205	751	-9.0	200	0	0	1422.6619	1	
174	0	1430.5436	0	730	2058	2857	4205	951	-17.0	200	1	1	1431.0626	1	
175	0	1435.7792	0	460	1105	2857	4205	901	-15.0	200	0	0	1436.7238	1	
176	0	1444.0338	0	730	2058	2857	4205	501	-18.5	200	-1	0	1445.3151	-1	
177	0	1454.8361	0	730	2058	2857	4205	1001	-17.0	200	1	1	1455.3163	1	
178	0	1461.2880	0	460	1105	2857	4205	501	-20.0	200	-1	0	1462.5204	-1	
179	0	1469.6632	0	460	1105	2857	4205	501	-20.0	200	-1	0	1470.5490	-1	
180	0	1477.6810	0	730	2058	2857	4205	551	-17.0	200	1	1	1478.5587	1	
181	0	1484.2357	0	730	2058	2857	4205	801	-17.0	200	1	1	1485.0313	1	
182	0	1490.1918	0	730	2058	2857	4205	651	-17.0	200	1	0	1490.6298	0	
183	1	1498.8068	0	730	2058	2857	4205	651	-17.0	200	1	1	1499.9079	1	
184	0	1504.1918	1	460	1105	2857	4205	551	-15.0	200	0	0	1506.3281	1	
185	0	1512.0964	0	730	2058	2857	4205	501	-18.5	200	-1	1	1514.3949	-1	
186	0	1520.3151	0	460	1105	2857	4205	951	-15.0	200	0	0	1521.0860	1	
187	0	1528.1906	0	460	1105	2857	4205	751	-9.0	200	0	0	1529.3155	1	
188	0	1535.6705	0	730	2058	2857	4205	851	-11.0	200	1	0	1536.6944	0	
189	1	1543.2665	0	730	2058	2857	4205	851	-11.0	200	1	1	1544.0657	1	
190	0	1549.8032	0	460	1105	2857	4205	601	-9.0	200	0	1	1551.1028	0	
191	1	1561.6437	0	460	1105	2857	4205	601	-9.0	200	0	0	1562.6022	1	
192	0	1569.6662	0	460	1105	2857	4205	501	-20.0	200	-1	0	1570.8566	-1	
