Trial	CorrectionTrial?	StartTime	CenterReward?	F1	F2	F3	F4	HoldTime	Atten	Pitch	Side	Response	RespTime	Correct	
1	0	6.524	0	730	2058	2857	4205	751	-11.0	149	0	0	9.591	1	
2	0	17.825	0	460	1105	2857	4205	501	-9.0	263	1	0	18.281	0	
3	1	32.036	0	460	1105	2857	4205	501	-9.0	263	1	1	33.041	1	
4	0	38.913	0	730	2058	2857	4205	601	-11.0	200	0	0	39.965	1	
5	0	48.780	0	730	2058	2857	4205	551	-11.0	459	0	0	49.924	1	
6	0	66.441	1	460	1105	2857	4205	901	-15.0	330	1	1	71.045	1	
7	0	76.690	0	730	2058	2857	4205	651	-17.0	149	0	0	77.639	1	
8	0	88.209	0	460	1105	2857	4205	801	-9.0	330	1	1	89.472	1	
9	0	95.023	0	460	1105	2857	4205	1001	-15.0	263	1	1	96.114	1	
10	0	110.081	0	460	1105	2857	4205	851	-15.0	200	1	1	111.234	1	
11	0	130.268	1	730	2058	2857	4205	951	-17.0	459	0	1	134.460	0	
12	1	167.311	0	730	2058	2857	4205	951	-17.0	459	0	0	168.462	1	
13	0	179.963	0	730	2058	2857	4205	901	-17.0	149	0	0	180.730	1	
14	0	190.743	0	460	1105	2857	4205	801	-15.0	459	1	1	192.133	1	
15	0	196.411	0	460	1105	2857	4205	1001	-9.0	200	1	1	197.143	1	
16	0	201.374	0	460	1105	2857	4205	501	-15.0	330	1	1	202.169	1	
17	0	207.211	0	730	2058	2857	4205	551	-11.0	263	0	1	208.577	0	
18	1	242.684	0	730	2058	2857	4205	551	-11.0	263	0	0	244.173	1	
19	0	253.832	0	730	2058	2857	4205	701	-17.0	330	0	0	254.652	1	
20	0	266.289	0	460	1105	2857	4205	651	-9.0	263	1	1	267.005	1	
21	0	281.868	0	730	2058	2857	4205	751	-17.0	459	0	0	282.618	1	
22	0	291.218	0	730	2058	2857	4205	951	-17.0	149	0	0	291.686	1	
23	0	306.844	0	460	1105	2857	4205	851	-9.0	200	1	1	307.652	1	
24	0	312.806	0	730	2058	2857	4205	951	-17.0	149	0	0	313.583	1	
25	0	325.133	0	730	2058	2857	4205	551	-17.0	459	0	0	325.878	1	
26	0	335.887	0	730	2058	2857	4205	851	-11.0	263	0	1	336.821	0	
27	1	343.657	0	730	2058	2857	4205	851	-11.0	263	0	0	344.559	1	
28	0	353.453	0	460	1105	2857	4205	701	-9.0	330	1	1	354.414	1	
29	0	358.654	0	460	1105	2857	4205	801	-15.0	200	1	1	359.476	1	
30	0	363.866	0	460	1105	2857	4205	501	-15.0	263	1	1	364.723	1	
31	0	370.030	0	730	2058	2857	4205	1001	-11.0	459	0	1	370.474	0	
32	1	379.254	0	730	2058	2857	4205	1001	-11.0	459	0	0	379.992	1	
33	0	390.254	0	730	2058	2857	4205	901	-11.0	149	0	0	390.968	1	
34	0	400.514	0	460	1105	2857	4205	751	-15.0	200	1	1	401.481	1	
35	0	406.385	0	460	1105	2857	4205	601	-15.0	330	1	1	407.269	1	
36	0	411.674	0	460	1105	2857	4205	501	-15.0	330	1	1	412.614	1	
37	0	417.790	0	730	2058	2857	4205	651	-11.0	263	0	0	418.852	1	
38	0	429.246	0	460	1105	2857	4205	901	-9.0	459	1	1	430.019	1	
39	0	435.075	0	460	1105	2857	4205	851	-9.0	149	1	1	435.886	1	
40	0	440.673	0	730	2058	2857	4205	751	-17.0	200	0	1	441.853	0	
41	1	450.110	0	730	2058	2857	4205	751	-17.0	200	0	0	451.013	1	
42	0	458.848	0	460	1105	2857	4205	551	-15.0	200	1	1	459.556	1	
43	0	463.828	0	730	2058	2857	4205	601	-17.0	263	0	0	464.747	1	
44	0	475.656	1	460	1105	2857	4205	1001	-15.0	459	1	1	480.063	1	
45	0	489.203	0	730	2058	2857	4205	951	-11.0	149	0	1	489.890	0	
46	1	524.385	0	730	2058	2857	4205	951	-11.0	149	0	0	524.994	1	
47	0	530.711	0	730	2058	2857	4205	801	-11.0	330	0	0	531.561	1	
48	0	536.811	0	730	2058	2857	4205	651	-11.0	200	0	0	537.695	1	
49	0	542.773	0	460	1105	2857	4205	551	-15.0	149	1	0	543.825	0	
50	1	559.213	0	460	1105	2857	4205	551	-15.0	149	1	1	560.053	1	
51	0	562.407	1	460	1105	2857	4205	851	-9.0	459	1	1	567.803	1	
52	0	572.033	0	460	1105	2857	4205	701	-9.0	330	1	1	572.895	1	
53	0	577.682	0	460	1105	2857	4205	601	-15.0	263	1	1	578.709	1	
54	0	584.335	0	730	2058	2857	4205	1001	-17.0	330	0	0	585.046	1	
55	0	596.330	0	730	2058	2857	4205	951	-17.0	263	0	0	597.111	1	
56	0	599.850	0	460	1105	2857	4205	501	-15.0	459	1	0	600.722	0	
57	1	609.355	0	460	1105	2857	4205	501	-15.0	459	1	1	610.102	1	
58	0	614.780	0	730	2058	2857	4205	901	-11.0	200	0	0	615.523	1	
59	0	624.339	0	730	2058	2857	4205	801	-17.0	149	0	0	624.938	1	
60	0	635.418	1	460	1105	2857	4205	651	-15.0	200	1	1	640.154	1	
61	0	644.692	0	730	2058	2857	4205	751	-17.0	149	0	1	645.722	0	
62	1	653.272	0	730	2058	2857	4205	751	-17.0	149	0	0	654.455	1	
63	0	663.990	0	460	1105	2857	4205	701	-9.0	459	1	1	664.516	1	
64	0	669.021	0	730	2058	2857	4205	601	-17.0	330	0	0	669.886	1	
65	0	681.966	1	460	1105	2857	4205	1001	-9.0	263	1	1	686.993	1	
66	0	691.609	0	730	2058	2857	4205	951	-11.0	149	0	1	692.245	0	
67	1	700.330	1	730	2058	2857	4205	951	-11.0	149	0	1	705.408	0	
68	1	712.813	0	730	2058	2857	4205	951	-11.0	149	0	0	713.654	1	
69	0	724.376	0	460	1105	2857	4205	801	-9.0	263	1	1	725.344	1	
70	0	728.859	0	460	1105	2857	4205	551	-15.0	459	1	1	729.903	1	
71	0	734.467	0	730	2058	2857	4205	501	-17.0	330	0	0	735.680	1	
72	0	737.481	0	730	2058	2857	4205	851	-17.0	200	0	0	738.284	1	
73	0	758.058	0	730	2058	2857	4205	801	-17.0	200	0	0	758.740	1	
74	0	772.703	0	460	1105	2857	4205	1001	-15.0	459	1	1	773.355	1	
75	0	778.301	0	730	2058	2857	4205	951	-17.0	149	0	0	779.200	1	
76	0	787.051	0	460	1105	2857	4205	901	-15.0	330	1	1	787.518	1	
77	0	791.937	0	730	2058	2857	4205	851	-11.0	263	0	0	792.925	1	
78	0	794.666	0	460	1105	2857	4205	601	-15.0	263	1	1	795.609	1	
79	0	800.004	0	460	1105	2857	4205	551	-15.0	459	1	1	800.838	1	
80	0	805.579	1	460	1105	2857	4205	701	-9.0	149	1	1	809.747	1	
81	0	814.039	0	730	2058	2857	4205	501	-11.0	200	0	1	815.179	0	
82	1	829.709	0	730	2058	2857	4205	501	-11.0	200	0	0	831.481	1	
83	0	842.145	0	730	2058	2857	4205	651	-11.0	330	0	1	843.024	0	
84	1	869.252	0	730	2058	2857	4205	651	-11.0	330	0	0	870.978	1	
85	0	884.251	0	460	1105	2857	4205	851	-15.0	330	1	1	885.160	1	
86	0	889.195	0	730	2058	2857	4205	601	-11.0	263	0	1	890.390	0	
87	1	896.677	0	730	2058	2857	4205	601	-11.0	263	0	1	897.636	0	
88	1	904.264	0	730	2058	2857	4205	601	-11.0	263	0	0	905.055	1	
89	0	913.706	0	730	2058	2857	4205	951	-11.0	459	0	0	914.461	1	
90	0	927.283	0	460	1105	2857	4205	801	-15.0	149	1	1	928.201	1	
91	0	932.587	0	460	1105	2857	4205	1001	-15.0	200	1	1	933.302	1	
92	0	937.685	1	730	2058	2857	4205	551	-11.0	200	0	1	941.486	0	
93	1	951.173	0	730	2058	2857	4205	551	-11.0	200	0	0	952.345	1	
94	0	964.172	0	730	2058	2857	4205	651	-11.0	459	0	0	964.960	1	
95	0	974.665	0	730	2058	2857	4205	701	-17.0	263	0	0	975.266	1	
96	0	985.013	0	460	1105	2857	4205	751	-15.0	330	1	1	985.598	1	
97	0	989.793	1	460	1105	2857	4205	901	-9.0	149	1	1	994.422	1	
98	0	998.646	0	460	1105	2857	4205	751	-9.0	330	1	1	999.432	1	
99	0	1003.458	0	460	1105	2857	4205	501	-9.0	263	1	1	1004.218	1	
100	0	1008.496	0	730	2058	2857	4205	551	-11.0	200	0	1	1009.633	0	
101	1	1017.612	0	730	2058	2857	4205	551	-11.0	200	0	0	1018.589	1	
102	0	1020.589	0	460	1105	2857	4205	601	-15.0	459	1	1	1021.421	1	
103	0	1025.961	0	730	2058	2857	4205	851	-17.0	149	0	0	1026.915	1	
104	0	1032.661	0	730	2058	2857	4205	701	-11.0	149	0	0	1033.437	1	
105	0	1054.320	0	730	2058	2857	4205	1001	-11.0	200	0	0	1055.059	1	
106	0	1058.356	0	460	1105	2857	4205	901	-9.0	330	1	1	1059.019	1	
107	0	1063.106	0	460	1105	2857	4205	651	-9.0	263	1	1	1063.999	1	
108	0	1068.809	1	730	2058	2857	4205	801	-17.0	459	0	1	1072.102	0	
109	1	1087.841	0	730	2058	2857	4205	801	-17.0	459	0	0	1088.838	1	
110	0	1094.996	0	730	2058	2857	4205	651	-11.0	200	0	1	1096.219	0	
111	1	1102.667	0	730	2058	2857	4205	651	-11.0	200	0	0	1103.685	1	
112	0	1115.659	0	460	1105	2857	4205	751	-9.0	459	1	1	1116.316	1	
113	0	1120.344	1	730	2058	2857	4205	551	-17.0	330	0	0	1123.623	1	
114	0	1127.236	0	460	1105	2857	4205	851	-9.0	263	1	1	1129.706	1	
115	0	1134.809	0	730	2058	2857	4205	1001	-11.0	149	0	0	1135.728	1	
116	0	1141.040	0	460	1105	2857	4205	901	-15.0	149	1	1	1141.738	1	
117	0	1146.172	0	730	2058	2857	4205	601	-11.0	200	0	0	1147.274	1	
118	0	1153.200	0	460	1105	2857	4205	701	-9.0	330	1	1	1153.688	1	
119	0	1157.631	0	730	2058	2857	4205	501	-11.0	263	0	0	1158.456	1	
120	0	1163.711	0	460	1105	2857	4205	951	-9.0	459	1	1	1164.356	1	
121	0	1168.218	1	460	1105	2857	4205	651	-9.0	263	1	1	1171.736	1	
122	0	1176.611	0	730	2058	2857	4205	1001	-11.0	330	0	0	1177.687	1	
123	0	1182.460	1	730	2058	2857	4205	851	-11.0	200	0	0	1185.639	1	
124	0	1191.249	0	460	1105	2857	4205	951	-9.0	149	1	1	1192.378	1	
125	0	1196.662	0	460	1105	2857	4205	701	-9.0	459	1	1	1197.594	1	
126	0	1201.493	0	730	2058	2857	4205	751	-11.0	263	0	0	1202.377	1	
127	0	1207.452	0	730	2058	2857	4205	501	-17.0	330	0	0	1208.332	1	
128	0	1212.904	0	730	2058	2857	4205	551	-11.0	149	0	0	1214.930	1	
129	0	1225.334	0	460	1105	2857	4205	601	-9.0	200	1	1	1226.237	1	
130	0	1230.103	0	460	1105	2857	4205	801	-15.0	459	1	1	1230.930	1	
131	0	1234.583	0	730	2058	2857	4205	601	-11.0	263	0	1	1235.680	0	
132	1	1243.060	0	730	2058	2857	4205	601	-11.0	263	0	0	1243.907	1	
133	0	1247.607	0	460	1105	2857	4205	701	-9.0	149	1	1	1248.504	1	
134	0	1252.580	0	460	1105	2857	4205	951	-9.0	459	1	1	1253.616	1	
135	0	1257.588	0	460	1105	2857	4205	1001	-9.0	200	1	1	1258.366	1	
136	0	1261.557	0	730	2058	2857	4205	501	-11.0	330	0	0	1262.553	1	
137	0	1266.572	0	460	1105	2857	4205	651	-9.0	330	1	1	1267.394	1	
138	0	1270.821	0	730	2058	2857	4205	551	-17.0	459	0	0	1271.859	1	
139	0	1278.303	1	730	2058	2857	4205	901	-17.0	149	0	0	1281.548	1	
140	0	1286.571	0	730	2058	2857	4205	801	-11.0	200	0	0	1287.648	1	
141	0	1291.925	0	460	1105	2857	4205	751	-15.0	263	1	0	1293.134	0	
142	1	1302.201	0	460	1105	2857	4205	751	-15.0	263	1	1	1302.683	1	
143	0	1306.711	0	730	2058	2857	4205	601	-11.0	200	0	0	1307.588	1	
144	0	1312.311	0	730	2058	2857	4205	901	-17.0	263	0	0	1312.961	1	
145	0	1315.930	0	730	2058	2857	4205	501	-17.0	149	0	0	1316.923	1	
146	0	1321.274	1	460	1105	2857	4205	801	-15.0	330	1	1	1325.364	1	
147	0	1329.026	0	460	1105	2857	4205	951	-15.0	459	1	1	1329.670	1	
148	0	1332.881	0	460	1105	2857	4205	651	-9.0	459	1	0	1333.973	0	
149	1	1342.299	0	460	1105	2857	4205	651	-9.0	459	1	1	1342.997	1	
150	0	1346.676	0	730	2058	2857	4205	851	-11.0	200	0	0	1348.000	1	
151	0	1351.595	0	460	1105	2857	4205	1001	-9.0	263	1	1	1352.293	1	
152	0	1355.803	0	730	2058	2857	4205	751	-11.0	330	0	0	1356.731	1	
153	0	1360.737	0	460	1105	2857	4205	701	-15.0	149	1	1	1361.513	1	
154	0	1365.371	0	730	2058	2857	4205	1001	-17.0	200	0	0	1366.473	1	
155	0	1369.996	0	730	2058	2857	4205	701	-17.0	459	0	0	1370.887	1	
156	0	1374.839	1	460	1105	2857	4205	501	-9.0	263	1	0	1378.336	0	
157	1	1384.581	0	460	1105	2857	4205	501	-9.0	263	1	1	1385.440	1	
158	0	1390.674	0	730	2058	2857	4205	601	-11.0	330	0	0	1391.513	1	
159	0	1395.707	0	460	1105	2857	4205	801	-9.0	149	1	1	1396.708	1	
160	0	1400.208	0	730	2058	2857	4205	751	-11.0	200	0	0	1401.462	1	
161	0	1405.660	0	460	1105	2857	4205	951	-15.0	459	1	1	1406.362	1	
162	0	1409.721	0	730	2058	2857	4205	901	-11.0	263	0	0	1410.864	1	
163	0	1415.076	0	460	1105	2857	4205	851	-9.0	330	1	1	1416.077	1	
164	0	1419.969	0	460	1105	2857	4205	651	-9.0	149	1	1	1420.756	1	
165	0	1425.184	0	730	2058	2857	4205	501	-17.0	149	0	0	1425.999	1	
166	0	1430.493	0	460	1105	2857	4205	651	-15.0	263	1	1	1431.562	1	
167	0	1435.382	0	730	2058	2857	4205	901	-17.0	459	0	0	1436.240	1	
168	0	1445.344	0	460	1105	2857	4205	851	-9.0	330	1	1	1445.977	1	
169	0	1449.753	0	730	2058	2857	4205	801	-11.0	200	0	0	1450.590	1	
170	0	1454.865	0	730	2058	2857	4205	701	-17.0	149	0	0	1455.754	1	
171	0	1460.024	0	730	2058	2857	4205	951	-11.0	200	0	0	1460.833	1	
172	0	1464.097	0	460	1105	2857	4205	601	-15.0	459	1	1	1465.129	1	
173	0	1468.804	1	460	1105	2857	4205	1001	-9.0	330	1	1	1472.924	1	
174	0	1477.125	0	460	1105	2857	4205	751	-9.0	263	1	1	1478.009	1	
175	0	1481.519	1	460	1105	2857	4205	751	-15.0	149	1	1	1485.390	1	
176	0	1488.904	0	730	2058	2857	4205	651	-17.0	459	0	0	1489.627	1	
177	0	1495.084	0	730	2058	2857	4205	501	-17.0	200	0	0	1496.013	1	
178	0	1501.016	0	730	2058	2857	4205	851	-17.0	330	0	0	1501.877	1	
179	0	1506.468	0	460	1105	2857	4205	951	-9.0	263	1	1	1507.461	1	
180	0	1511.305	0	460	1105	2857	4205	1001	-15.0	200	1	0	1512.047	0	
181	1	1526.907	0	460	1105	2857	4205	1001	-15.0	200	1	1	1527.626	1	
182	0	1531.907	0	730	2058	2857	4205	551	-11.0	330	0	0	1532.802	1	
183	0	1537.681	0	460	1105	2857	4205	801	-9.0	263	1	1	1538.561	1	
184	0	1541.678	0	730	2058	2857	4205	601	-17.0	459	0	0	1542.885	1	
185	0	1546.973	0	460	1105	2857	4205	901	-15.0	149	1	1	1547.579	1	
186	0	1550.988	0	730	2058	2857	4205	801	-11.0	200	0	0	1551.818	1	
187	0	1556.165	0	730	2058	2857	4205	1001	-11.0	330	0	0	1557.089	1	
188	0	1561.524	0	460	1105	2857	4205	501	-9.0	459	1	1	1562.544	1	
189	0	1565.834	0	730	2058	2857	4205	701	-17.0	263	0	0	1567.859	1	
190	0	1571.940	0	460	1105	2857	4205	851	-15.0	149	1	1	1572.866	1	
191	0	1576.376	0	460	1105	2857	4205	551	-15.0	459	1	1	1577.354	1	
192	0	1580.880	0	460	1105	2857	4205	901	-9.0	200	1	1	1582.088	1	
193	0	1586.314	0	460	1105	2857	4205	951	-9.0	330	1	1	1587.025	1	
194	0	1590.794	0	730	2058	2857	4205	651	-11.0	149	0	0	1591.474	1	
195	0	1595.681	0	730	2058	2857	4205	751	-17.0	263	0	0	1596.655	1	
196	0	1607.019	1	730	2058	2857	4205	751	-11.0	459	0	0	1610.362	1	
197	0	1614.431	0	730	2058	2857	4205	501	-17.0	200	0	0	1615.606	1	
198	0	1618.962	0	460	1105	2857	4205	701	-9.0	149	1	1	1619.664	1	
199	0	1623.601	0	460	1105	2857	4205	651	-15.0	330	1	1	1630.809	1	
200	0	1634.783	0	460	1105	2857	4205	551	-15.0	263	1	1	1635.635	1	
201	0	1639.395	0	730	2058	2857	4205	601	-11.0	149	0	0	1640.553	1	
202	0	1646.187	0	730	2058	2857	4205	901	-11.0	330	0	1	1647.005	0	
203	1	1886.160	0	730	2058	2857	4205	901	-11.0	330	0	1	1887.600	0	
