Trial	CorrectionTrial?	StartTime	CenterReward?	F1	F2	F3	F4	HoldTime	Atten	Pitch	Side	Response	RespTime	Correct	
1	0	14.6081	0	730	2058	2857	4205	751	-14.0	330	1	1	15.0588	1	
2	0	27.1047	0	460	1105	2857	4205	651	-12.0	459	0	0	27.6522	1	
3	0	47.1869	1	460	1105	2857	4205	951	-12.0	149	0	0	47.6251	1	
4	0	54.7359	0	460	1105	2857	4205	901	-12.0	200	0	0	57.9411	1	
5	0	65.3128	0	460	1105	2857	4205	551	-12.0	459	0	0	66.2183	1	
6	0	73.3979	0	730	2058	2857	4205	501	-14.0	200	1	1	73.9963	1	
7	0	83.8465	0	730	2058	2857	4205	1001	-14.0	149	1	1	84.2318	1	
8	0	93.4368	0	460	1105	2857	4205	701	-12.0	263	0	1	94.1424	0	
9	1	101.2053	1	460	1105	2857	4205	701	-12.0	263	0	1	105.1807	0	
10	1	111.0623	0	460	1105	2857	4205	701	-12.0	263	0	0	111.4431	1	
11	0	117.3415	1	730	2058	2857	4205	601	-14.0	330	1	1	117.8051	1	
12	0	122.1472	0	730	2058	2857	4205	551	-14.0	200	1	1	127.0545	1	
13	0	132.6874	0	460	1105	2857	4205	1001	-12.0	263	0	0	133.4694	1	
14	0	144.7630	1	730	2058	2857	4205	901	-14.0	149	1	1	145.1984	1	
15	0	150.3657	0	579	1508	2857	4205	501	-12.0	200	-1	1	155.0352	-1	
16	0	159.4302	1	460	1105	2857	4205	501	-12.0	330	0	0	160.4434	1	
17	0	166.3565	0	730	2058	2857	4205	651	-14.0	200	1	1	170.0235	1	
18	0	174.9836	0	730	2058	2857	4205	601	-14.0	459	1	1	175.5263	1	
19	0	182.3732	0	730	2058	2857	4205	751	-14.0	330	1	1	183.4414	1	
20	0	188.2629	0	460	1105	2857	4205	801	-12.0	149	0	0	189.3316	1	
21	0	198.8787	0	730	2058	2857	4205	951	-14.0	263	1	1	199.4217	1	
22	0	204.0169	1	460	1105	2857	4205	751	-12.0	459	0	0	204.9639	1	
23	0	209.0023	0	460	1105	2857	4205	801	-12.0	263	0	0	213.1079	1	
24	0	220.5508	0	730	2058	2857	4205	701	-14.0	149	1	0	221.6874	0	
25	1	229.0096	0	730	2058	2857	4205	701	-14.0	149	1	1	229.4025	1	
26	0	234.4508	1	460	1105	2857	4205	601	-12.0	200	0	1	238.8135	0	
27	1	245.9531	0	460	1105	2857	4205	601	-12.0	200	0	0	246.3198	1	
28	0	251.2910	0	730	2058	2857	4205	501	-14.0	330	1	1	251.7412	1	
29	0	256.6119	0	730	2058	2857	4205	851	-14.0	330	1	1	257.0697	1	
30	0	262.7135	0	579	1508	2857	4205	501	-12.0	200	-1	1	263.5248	-1	
31	0	278.0312	0	460	1105	2857	4205	951	-12.0	459	0	0	278.3800	1	
32	0	285.2358	0	460	1105	2857	4205	551	-12.0	263	0	1	285.7503	0	
33	1	296.8163	0	460	1105	2857	4205	551	-12.0	263	0	0	297.9859	1	
34	0	310.2083	0	460	1105	2857	4205	901	-12.0	200	0	0	310.6036	1	
35	0	323.5329	0	730	2058	2857	4205	701	-14.0	263	1	1	323.9650	1	
36	0	331.7032	0	730	2058	2857	4205	801	-14.0	149	1	1	332.0987	1	
37	0	338.4670	0	460	1105	2857	4205	1001	-12.0	200	0	0	338.9659	1	
38	0	342.8296	0	460	1105	2857	4205	651	-12.0	459	0	0	343.2330	1	
39	0	351.7424	0	730	2058	2857	4205	901	-14.0	330	1	1	352.1925	1	
40	0	357.2427	0	730	2058	2857	4205	551	-14.0	200	1	1	357.6496	1	
41	0	365.2064	0	730	2058	2857	4205	851	-14.0	263	1	1	365.7250	1	
42	0	370.6659	0	579	1508	2857	4205	501	-12.0	200	-1	1	371.4859	-1	
43	0	384.5161	0	460	1105	2857	4205	951	-12.0	149	0	0	385.0047	1	
44	0	393.2886	1	460	1105	2857	4205	751	-12.0	459	0	0	397.1484	1	
45	0	402.4730	0	460	1105	2857	4205	501	-12.0	149	0	0	403.2235	1	
46	0	409.3610	0	730	2058	2857	4205	601	-14.0	263	1	1	409.7511	1	
47	0	415.9583	0	730	2058	2857	4205	901	-14.0	459	1	1	416.6910	1	
48	0	422.2758	0	460	1105	2857	4205	1001	-12.0	200	0	0	422.6027	1	
49	0	428.5455	0	460	1105	2857	4205	701	-12.0	330	0	1	429.6310	0	
50	1	437.9826	0	460	1105	2857	4205	701	-12.0	330	0	0	439.0022	1	
51	0	448.7499	0	730	2058	2857	4205	951	-14.0	330	1	1	449.4868	1	
52	0	458.9271	0	730	2058	2857	4205	751	-14.0	263	1	1	459.5069	1	
53	0	465.4733	0	579	1508	2857	4205	501	-12.0	200	-1	1	466.4193	-1	
54	0	475.5239	0	460	1105	2857	4205	801	-12.0	200	0	0	475.9469	1	
55	0	483.5293	0	730	2058	2857	4205	651	-14.0	459	1	1	483.8647	1	
56	0	488.0225	0	730	2058	2857	4205	701	-14.0	459	1	1	488.4167	1	
57	0	493.2666	0	460	1105	2857	4205	551	-12.0	330	0	1	494.2306	0	
58	1	501.5090	0	460	1105	2857	4205	551	-12.0	330	0	0	502.1160	1	
59	0	507.8268	1	460	1105	2857	4205	601	-12.0	149	0	1	508.4120	0	
60	1	515.4473	0	460	1105	2857	4205	601	-12.0	149	0	0	516.4199	1	
61	0	526.0631	0	460	1105	2857	4205	1001	-12.0	263	0	0	526.4812	1	
62	0	532.1172	0	730	2058	2857	4205	501	-14.0	200	1	1	532.8446	1	
63	0	539.9384	0	730	2058	2857	4205	651	-14.0	149	1	1	540.3991	1	
64	0	551.4649	0	460	1105	2857	4205	851	-12.0	200	0	0	552.0758	1	
65	0	560.7961	0	460	1105	2857	4205	751	-12.0	263	0	0	561.3792	1	
66	0	567.2550	0	460	1105	2857	4205	801	-12.0	330	0	0	568.0941	1	
67	0	580.8431	0	730	2058	2857	4205	951	-14.0	459	1	1	581.2298	1	
68	0	586.0064	0	730	2058	2857	4205	1001	-14.0	263	1	1	586.3983	1	
69	0	591.2952	0	730	2058	2857	4205	601	-14.0	459	1	1	592.2433	1	
70	0	596.0192	1	579	1508	2857	4205	501	-12.0	200	-1	1	600.0428	-1	
71	0	605.0522	0	460	1105	2857	4205	551	-12.0	149	0	0	606.4465	1	
72	0	612.2685	0	730	2058	2857	4205	851	-14.0	330	1	1	613.1027	1	
73	0	626.6226	0	460	1105	2857	4205	951	-12.0	459	0	0	627.1067	1	
74	0	635.3125	0	730	2058	2857	4205	651	-14.0	330	1	1	635.8786	1	
75	0	639.7417	0	579	1508	2857	4205	501	-12.0	200	-1	1	640.7024	-1	
76	0	644.5693	0	460	1105	2857	4205	801	-12.0	149	0	0	645.0152	1	
77	0	651.1109	0	730	2058	2857	4205	701	-14.0	200	1	0	652.4837	0	
78	1	660.1930	0	730	2058	2857	4205	701	-14.0	200	1	1	660.6281	1	
79	0	663.8865	0	460	1105	2857	4205	551	-12.0	459	0	0	664.2031	1	
80	0	672.7471	1	730	2058	2857	4205	801	-14.0	200	1	1	673.3455	1	
81	0	678.3168	0	460	1105	2857	4205	701	-12.0	263	0	1	682.4926	0	
82	1	689.6735	1	460	1105	2857	4205	701	-12.0	263	0	0	693.9320	1	
83	0	699.3246	0	460	1105	2857	4205	851	-12.0	149	0	0	700.1415	1	
84	0	705.4909	1	730	2058	2857	4205	501	-14.0	330	1	1	705.9150	1	
85	0	710.6687	0	730	2058	2857	4205	1001	-14.0	263	1	1	713.8746	1	
86	0	719.5169	1	460	1105	2857	4205	751	-12.0	330	0	1	723.9258	0	
87	1	730.4593	0	460	1105	2857	4205	751	-12.0	330	0	0	731.1743	1	
88	0	736.0057	1	579	1508	2857	4205	501	-12.0	200	-1	0	740.0239	-1	
89	0	745.8830	0	460	1105	2857	4205	601	-12.0	200	0	0	746.3212	1	
90	0	750.8633	0	730	2058	2857	4205	651	-14.0	459	1	1	751.3323	1	
91	0	756.8175	0	730	2058	2857	4205	801	-14.0	459	1	1	757.7586	1	
92	0	765.3144	0	730	2058	2857	4205	901	-14.0	263	1	1	765.7632	1	
93	0	770.7743	0	730	2058	2857	4205	551	-14.0	200	1	1	771.6272	1	
94	0	777.5058	0	460	1105	2857	4205	851	-12.0	330	0	0	777.9293	1	
95	0	784.5721	0	460	1105	2857	4205	1001	-12.0	149	0	0	785.0520	1	
96	0	790.7711	0	460	1105	2857	4205	501	-12.0	149	0	0	791.5110	1	
97	0	802.9759	0	460	1105	2857	4205	751	-12.0	263	0	1	803.6889	0	
98	1	812.3809	0	460	1105	2857	4205	751	-12.0	263	0	0	813.0562	1	
99	0	817.5618	0	730	2058	2857	4205	601	-14.0	200	1	1	817.9909	1	
100	0	821.6742	0	730	2058	2857	4205	701	-14.0	330	1	1	822.1709	1	
101	0	827.4036	0	730	2058	2857	4205	651	-14.0	459	1	1	828.0791	1	
102	0	832.8558	0	460	1105	2857	4205	701	-12.0	459	0	0	833.3144	1	
103	0	837.4494	0	579	1508	2857	4205	501	-12.0	200	-1	1	838.3934	-1	
104	0	842.3723	0	730	2058	2857	4205	1001	-14.0	149	1	1	842.7452	1	
105	0	847.6585	0	460	1105	2857	4205	601	-12.0	200	0	0	848.1513	1	
106	0	852.3188	0	460	1105	2857	4205	551	-12.0	330	0	0	853.1843	1	
107	0	857.9085	0	460	1105	2857	4205	501	-12.0	149	0	0	858.4162	1	
108	0	864.0702	0	460	1105	2857	4205	651	-12.0	330	0	0	864.7098	1	
109	0	874.6457	0	730	2058	2857	4205	751	-14.0	263	1	1	875.1668	1	
110	0	880.6858	1	730	2058	2857	4205	901	-14.0	200	1	1	884.8914	1	
111	0	889.8416	0	460	1105	2857	4205	801	-12.0	459	0	0	890.8017	1	
112	0	896.2949	0	730	2058	2857	4205	551	-14.0	200	1	1	897.2186	1	
113	0	901.9792	0	579	1508	2857	4205	501	-12.0	200	-1	1	903.0087	-1	
114	0	906.3784	0	730	2058	2857	4205	751	-14.0	149	1	1	907.5278	1	
115	0	911.8713	0	460	1105	2857	4205	851	-12.0	330	0	0	912.7115	1	
116	0	918.1318	0	460	1105	2857	4205	951	-12.0	459	0	0	918.3997	1	
117	0	923.6809	0	730	2058	2857	4205	1001	-14.0	200	1	1	924.0129	1	
118	0	928.9852	0	460	1105	2857	4205	801	-12.0	330	0	0	929.4125	1	
119	0	935.2253	1	460	1105	2857	4205	651	-12.0	149	0	0	938.3626	1	
120	0	944.4154	0	730	2058	2857	4205	901	-14.0	459	1	1	945.2069	1	
121	0	949.4423	1	730	2058	2857	4205	601	-14.0	263	1	1	953.1705	1	
122	0	958.5602	0	730	2058	2857	4205	551	-14.0	459	1	1	959.7935	1	
123	0	964.4071	0	460	1105	2857	4205	651	-12.0	263	0	0	965.2691	1	
124	0	970.0232	1	460	1105	2857	4205	601	-12.0	149	0	1	970.8138	0	
125	1	979.0414	0	460	1105	2857	4205	601	-12.0	149	0	1	980.0665	0	
126	1	986.8533	0	460	1105	2857	4205	601	-12.0	149	0	0	987.5313	1	
127	0	995.1678	0	730	2058	2857	4205	901	-14.0	200	1	1	995.7443	1	
128	0	999.9333	1	579	1508	2857	4205	501	-12.0	200	-1	1	1003.5837	-1	
129	0	1008.8324	0	730	2058	2857	4205	751	-14.0	149	1	1	1010.2866	1	
130	0	1014.1450	0	460	1105	2857	4205	951	-12.0	263	0	1	1015.0074	0	
131	1	1025.0868	0	460	1105	2857	4205	951	-12.0	263	0	0	1025.7324	1	
132	0	1030.8925	0	730	2058	2857	4205	1001	-14.0	459	1	1	1031.2891	1	
133	0	1036.5914	0	460	1105	2857	4205	701	-12.0	330	0	1	1037.4255	0	
134	1	1043.9810	0	460	1105	2857	4205	701	-12.0	330	0	0	1044.9252	1	
135	0	1050.8815	0	730	2058	2857	4205	801	-14.0	200	1	1	1051.5054	1	
136	0	1055.1390	0	460	1105	2857	4205	551	-12.0	149	0	0	1055.8100	1	
137	0	1060.4169	1	460	1105	2857	4205	651	-12.0	459	0	0	1063.7709	1	
138	0	1068.7532	0	730	2058	2857	4205	501	-14.0	330	1	1	1070.1509	1	
139	0	1075.1322	0	730	2058	2857	4205	1001	-14.0	263	1	1	1075.9067	1	
140	0	1079.8448	1	460	1105	2857	4205	951	-12.0	200	0	1	1083.2550	0	
141	1	1091.8307	0	460	1105	2857	4205	951	-12.0	200	0	0	1092.5330	1	
142	0	1106.7607	0	730	2058	2857	4205	901	-14.0	149	1	1	1107.2609	1	
143	0	1111.6843	1	730	2058	2857	4205	601	-14.0	263	1	1	1116.0181	1	
144	0	1120.4996	0	730	2058	2857	4205	851	-14.0	330	1	1	1121.7098	1	
145	0	1127.0944	0	460	1105	2857	4205	801	-12.0	459	0	0	1128.1065	1	
146	0	1132.9942	0	579	1508	2857	4205	501	-12.0	200	-1	1	1134.1676	-1	
147	0	1139.2488	0	460	1105	2857	4205	551	-12.0	330	0	0	1140.1336	1	
148	0	1147.2884	0	460	1105	2857	4205	651	-12.0	459	0	0	1148.0686	1	
149	0	1153.7793	0	730	2058	2857	4205	951	-14.0	263	1	1	1154.0701	1	
150	0	1159.1231	0	730	2058	2857	4205	901	-14.0	200	1	1	1159.6458	1	
151	0	1164.5306	0	460	1105	2857	4205	801	-12.0	149	0	0	1165.2057	1	
152	0	1169.2154	0	460	1105	2857	4205	851	-12.0	200	0	0	1169.5632	1	
153	0	1175.0934	0	730	2058	2857	4205	751	-14.0	263	1	1	1175.5210	1	
154	0	1180.2295	0	460	1105	2857	4205	701	-12.0	330	0	0	1181.2135	1	
155	0	1186.0255	0	730	2058	2857	4205	601	-14.0	459	1	1	1186.4465	1	
156	0	1192.0510	0	579	1508	2857	4205	501	-12.0	200	-1	0	1193.8107	-1	
157	0	1198.4698	0	460	1105	2857	4205	651	-12.0	149	0	0	1198.9661	1	
158	0	1207.1766	0	460	1105	2857	4205	551	-12.0	330	0	0	1208.0849	1	
159	0	1224.2413	0	730	2058	2857	4205	1001	-14.0	263	1	1	1225.0187	1	
160	0	1237.2744	0	460	1105	2857	4205	751	-12.0	200	0	0	1237.8150	1	
161	0	1247.9676	0	460	1105	2857	4205	801	-12.0	459	0	0	1248.7622	1	
162	0	1256.7887	0	460	1105	2857	4205	501	-12.0	149	0	0	1257.7572	1	
163	0	1263.9692	0	730	2058	2857	4205	851	-14.0	263	1	1	1264.3126	1	
164	0	1268.2694	0	579	1508	2857	4205	501	-12.0	200	-1	1	1269.3679	-1	
165	0	1274.8783	0	730	2058	2857	4205	951	-14.0	330	1	1	1275.4668	1	
166	0	1280.1534	0	460	1105	2857	4205	701	-12.0	459	0	0	1280.5464	1	
167	0	1287.3545	0	730	2058	2857	4205	751	-14.0	459	1	1	1287.7568	1	
168	0	1292.0622	0	460	1105	2857	4205	601	-12.0	149	0	0	1292.8347	1	
169	0	1300.6696	1	730	2058	2857	4205	501	-14.0	263	1	1	1301.2290	1	
170	0	1306.7566	0	730	2058	2857	4205	551	-14.0	200	1	1	1310.5281	1	
171	0	1315.6207	0	730	2058	2857	4205	951	-14.0	330	1	1	1315.9759	1	
172	0	1322.3789	0	579	1508	2857	4205	501	-12.0	200	-1	0	1323.2724	-1	
173	0	1329.2738	0	460	1105	2857	4205	1001	-12.0	263	0	0	1329.9442	1	
174	0	1335.7303	0	460	1105	2857	4205	701	-12.0	200	0	0	1336.3642	1	
175	0	1344.0246	0	730	2058	2857	4205	851	-14.0	459	1	1	1344.9007	1	
176	0	1349.5221	0	460	1105	2857	4205	901	-12.0	149	0	0	1350.1569	1	
177	0	1360.0852	0	460	1105	2857	4205	901	-12.0	263	0	0	1361.3330	1	
178	0	1366.5076	1	730	2058	2857	4205	701	-14.0	459	1	1	1372.0413	1	
179	0	1376.1439	0	460	1105	2857	4205	801	-12.0	330	0	1	1376.9268	0	
180	1	1383.7440	0	460	1105	2857	4205	801	-12.0	330	0	0	1384.3713	1	
181	0	1389.2413	0	730	2058	2857	4205	551	-14.0	149	1	1	1389.7925	1	
182	0	1395.3678	0	730	2058	2857	4205	751	-14.0	200	1	1	1395.7476	1	
183	0	1404.5540	0	460	1105	2857	4205	651	-12.0	330	0	0	1405.2930	1	
184	0	1413.7849	0	730	2058	2857	4205	951	-14.0	459	1	1	1414.3447	1	
185	0	1419.0060	0	460	1105	2857	4205	851	-12.0	263	0	1	1420.0781	0	
186	1	1427.3102	1	460	1105	2857	4205	851	-12.0	263	0	0	1428.0514	1	
187	0	1432.0191	0	460	1105	2857	4205	501	-12.0	200	0	0	1435.8988	1	
188	0	1442.6294	0	730	2058	2857	4205	601	-14.0	149	1	1	1443.3406	1	
189	0	1448.7242	0	460	1105	2857	4205	951	-12.0	330	0	0	1449.5200	1	
190	0	1454.6110	0	730	2058	2857	4205	551	-14.0	200	1	1	1455.7100	1	
191	0	1459.5498	0	730	2058	2857	4205	701	-14.0	263	1	1	1460.3121	1	
192	0	1464.9421	0	730	2058	2857	4205	751	-14.0	459	1	1	1465.6260	1	
193	0	1473.8771	0	460	1105	2857	4205	651	-12.0	149	0	0	1474.6649	1	
194	0	1479.3757	0	579	1508	2857	4205	501	-12.0	200	-1	1	1479.9171	-1	
195	0	1485.8877	0	730	2058	2857	4205	851	-14.0	149	1	1	1486.3496	1	
196	0	1492.3470	0	730	2058	2857	4205	801	-14.0	330	1	1	1493.1231	1	
197	0	1501.1339	0	460	1105	2857	4205	1001	-12.0	459	0	0	1501.5092	1	
198	0	1505.9563	0	460	1105	2857	4205	501	-12.0	200	0	0	1506.3941	1	
199	0	1513.3476	0	730	2058	2857	4205	951	-14.0	263	1	1	1514.2540	1	
200	0	1519.5113	0	730	2058	2857	4205	651	-14.0	149	1	1	1519.9891	1	
201	0	1530.9672	0	730	2058	2857	4205	901	-14.0	459	1	1	1532.0080	1	
202	0	1540.2313	0	460	1105	2857	4205	851	-12.0	330	0	0	1540.8264	1	
203	0	1560.6786	0	579	1508	2857	4205	501	-12.0	200	-1	1	1561.8556	-1	
204	0	1760.9474	0	460	1105	2857	4205	751	-12.0	200	0	-1	-1.0000	0	
